g g g g g g g g g g g g g x g
g p p p g p p p g p p p g p g
g p g p g p g p g p g p g p g
g p g p g p g p g p g p g p g
g p g p g p g p g p g p g p g
g p g p g p g p g p g p g p g
g p g p p p g p p p g p p p g
g s g g g g g g g g g g g g g